   3  2  1  3  2
2 [3, 2, 5, 1, 4] 2
2 [1, 5, 3, 4, 2] 3
3 [2, 1, 4, 5, 3] 2
2 [4, 3, 1, 2, 5] 1
1 [5, 4, 2, 3, 1] 4
   1  2  3  2  2