   4  3  2  3  2  1
4 [1, 4, 3, 2, 5, 6] 1
2 [4, 1, 6, 5, 2, 3] 3
2 [5, 2, 1, 6, 3, 4] 2
3 [2, 5, 4, 3, 6, 1] 2
2 [3, 6, 5, 4, 1, 2] 4
1 [6, 3, 2, 1, 4, 5] 2
   1  2  3  3  2  2
