   2  3  2  3  3  1  3  3
4 [2, 6, 7, 4, 3, 8, 1, 5] 2
1 [8, 4, 5, 2, 1, 6, 7, 3] 3
3 [3, 7, 8, 5, 4, 1, 2, 6] 2
2 [7, 3, 4, 1, 8, 5, 6, 2] 3
2 [6, 2, 3, 8, 7, 4, 5, 1] 4
5 [1, 5, 6, 3, 2, 7, 8, 4] 2
3 [5, 1, 2, 7, 6, 3, 4, 8] 1
2 [4, 8, 1, 6, 5, 2, 3, 7] 2
   5  1  4  3  4  4  3  2
