   5  4  2  3  1  2  3  4  4
4 [1, 2, 7, 5, 9, 8, 6, 4, 3] 5
3 [3, 4, 9, 7, 2, 1, 8, 6, 5] 4
3 [5, 6, 2, 9, 4, 3, 1, 8, 7] 3
4 [2, 3, 8, 6, 1, 9, 7, 5, 4] 4
2 [8, 9, 5, 3, 7, 6, 4, 2, 1] 6
3 [7, 8, 4, 2, 6, 5, 3, 1, 9] 1
3 [6, 7, 3, 1, 5, 4, 2, 9, 8] 2
1 [9, 1, 6, 4, 8, 7, 5, 3, 2] 6
4 [4, 5, 1, 8, 3, 2, 9, 7, 6] 3
   2  4  4  2  3  3  1  2  3
